...###.....
..##.#.####
.##..###.@#
##........#
#......#..#
###..###..#
..#..#....#
.##.##.#.##
.#......##.
.#.....##..
.#######...