...###.....
..##.#.####
.##..###..#
##........#
#......#..#
###..###..#
..#..#....#
.##.##.#.##
.#......##.
.#....@##..
.#######...