...###.....
..##.#.####
.##..###..#
##........#
#@.....#..#
###..###..#
..#..#....#
.##.##.#.##
.#......##.
.#.....##..
.#######...