...###.....
..#..#.####
.##..###..#
.#........#
#.........#
.##........
..#.......#
.##....#.##
.#......##.
.#....@.#..
.#######...